NO./path_to_the_north_texture.xpm
SO./path_to_the_south_texture.xpm
WE./path_to_the_west_texture.xpm
EA ./path_to_the_east_texture.xpm
F 220,100,0


F 220,100,0
C 225,30,0

        111111111111111111111
        100000000011000000001
        1011000001110000000011
        1001000000000000000001
111111111011000001110000000001
100000000011000001110111111111
11110111111111011100000010001
11110111111111011101010010001
11000000110111011100000010001
10000000000000000000000000001
10000000000000001101010010001
1100000111010101111101111E001
11111111111111111111111111111